1111111111111
10010000000C1
1000011110001
1P0011E000001
100000000P001
10000C0000C01
1111111111111