1111111111111
1111111111111
1111111111111
111111111E111
1111111111111
11111C1P11111
1111111111111