1111111111111
10010000000C1
1000011110001
1P0011E000001
1000000000001
10000C0000C01
1111111111111