1111111111
1P00E00001
1000C00001
1000000E01
1111111111 