1111111111
1P00000001
1000C00001
1111111111 