1111111111
1P00000001
100000001
1000C00E01
1111111111 